111111111111111111111111111111111111111111111111111111111111111111111111111111111111111111111111111111111
101011100010101100011101000111100200110020110011000100011011000000000000000000000000000001111111111111111
101020000000100001111101100102201100000220110010010111000000000000000000000000000000000001111111111111111
101002012110220100221100100100100100000000000010110001001101000000000000000000000000000001111111111111111
121011112010101010020000100210000111000001121010010010001101100000000000000000000000000001111111111111111
100020010010100010011100100221100110001111220010010111011100100000000000000000000000000001111111111111111
102010010010001110022110000110000100011001110010010011001100100000000000000000000000000001111111111111111
101111001022100100111110100002101110000000110211010010000000001000000000000000000000000001111111111111111
100000000002100000011100110022110000000000110022010000111010010000000000000000000000000001111111111111111
111111111111111111111111111111111111111111111111111111111111111111111111111111111111111111111111111111111