111111111111111111111111111111111111111111111111111111111111111111111111111111111111111111111111111111111
100001100010001100001111010001111002001100201100110001000110110000000022200000000000000000011111111111111
112121100100100010011110110010220110000022011001001011100000000000000000000000001111000000111111111111111
100101001120000012112110010010010010000000000001011000100110100000001111000000000000000000111111111111111
100100000121101000012000010021000011100000112101001001000110110000000000000000000000000000111111111111111
101110100000201011021110010022110011000111122001001011101110010000000000000000000000000000111111111111111
100200112100102001122211000011000010001100111001001001100110010000000000011110000000000000111111111111111
110110100000001000011111010000210111000000011021101001000000000100000000000000000000000000111111111111111
100020100011002000111110011002211000000000011002201000011101001000000000000002200000000000111111111111111
111111111111111111111111111111111111111111111111111111111111111111111111111111111111111111111111111111111