000000000000000000000000000000000000000000000000000000000000
000000000000000000000000000000000000000000000000000000000000
000000000000000000000000000000000000000000000000000000000001
000000000000000000000000000000000000000000000000000000000011
000000000011100000000011100000000011100000000011100000000111
000011000000000000100000000011000011100001100000111000111111
000000011000000011100000000011100000000111000000000000111111
111111111111111111111111111111111111111111111111111111111111
111111111111111111111111111111111111111111111111111111111111
111111111111111111111111111111111111111111111111111111111111
111111111111111111111111111111111111111111111111111111111111