111111111111111111111111111111111111111111111111111111111111111111111111111111111111111111111111111111111
100000000000000000011100000000000000000000110000000000000000000000000000000000000000000001111111111111111
100000000000000000011100000000000000000000110000000000000000000000000000000000000000000001111111111111111
100000011110000000011100000100000000000000000000000000000000000000000000000000000000000001111111111111111
100000010010000000000000000110000000000111110000000000000000000000000000000000000000000001111111111111111
100000010010000000011100000111100000000111110000000000000000000000000000000000000000000001111111111111111
100000011110000000011100000110000000000001110000000000000000000000000000000000000000000001111111111111111
100000000000000000011100000100000000000000110000000000000000000000000000000000000000000001111111111111111
100000000000000000011100000000000000000000110000000000000000000000000000000000000000000001111111111111111
111111111111111111111111111111111111111111111111111111111111111111111111111111111111111111111111111111111